[console_scripts]
HEN2xspec = hendrics.save_as_xspec:main
HENaccelsearch = hendrics.efsearch:main_accelsearch
HENbaseline = hendrics.lcurve:baseline_main
HENbinary = hendrics.binary:main_presto
HENcalibrate = hendrics.calibrate:main
HENcolors = hendrics.colors:main
HENcreategti = hendrics.create_gti:main
HENdeorbit = hendrics.fold:main_deorbit
HENdumpdyn = hendrics.fspec:dumpdyn_main
HENefsearch = hendrics.efsearch:main_efsearch
HENexcvar = hendrics.exvar:main
HENexposure = hendrics.exposure:main
HENfake = hendrics.fake:main
HENfold = hendrics.fold:main_fold
HENfspec = hendrics.fspec:main
HENjoinevents = hendrics.read_events:main_join
HENlags = hendrics.timelags:main
HENlcurve = hendrics.lcurve:main
HENmodel = hendrics.modeling:main_model
HENphaseogram = hendrics.phaseogram:main_phaseogram
HENphasetag = hendrics.phasetag:main_phasetag
HENplot = hendrics.plot:main
HENreadevents = hendrics.read_events:main
HENreadfile = hendrics.io:main
HENrebin = hendrics.rebin:main
HENscramble = hendrics.fake:main_scramble
HENscrunchlc = hendrics.lcurve:scrunch_main
HENsplitevents = hendrics.read_events:main_splitevents
HENsumfspec = hendrics.sum_fspec:main
HENvarenergy = hendrics.varenergy:main
HENz2vspf = hendrics.efsearch:main_z2vspf
HENzsearch = hendrics.efsearch:main_zsearch

